+---+---+---+---+---+---+---+---+---+---+---+---+---+---+---+---+
|       |                                       |       |       |
+   +   +   +---+---+---+   +---+---+---+---+   +   +   +   +   +
|   |   |   |       |       |                   |   |   |   |   |
+   +   +   +   +   +   +---+   +---+---+---+---+   +   +   +   +
|   |       |   |           |                   |   |       |   |
+   +---+---+   +   +---+---+---+---+---+---+   +   +---+---+   +
|               |   |                           |           |   |
+   +---+---+---+   +   +---+---+---+---+---+   +---+---+   +   +
|   |               |   |               |       |           |   |
+   +   +---+   +---+   +   +   +---+   +   +---+   +---+   +   +
|       |       |   |   |   |       |   |       |   |       |   |
+   +---+   +---+   +   +---+   +   +   +---+   +   +   +---+   +
|   |               |   |   |   |   |   |       |           |   |
+   +   +---+---+   +   +   +   +---+   +   +---+   +---+   +   +
|       |           |   |   |       |   |   |               |   |
+---+---+---+---+---+---+   +---+   +   +   +   +---+   +---+   +
|           |           |       |   |   |       |           |   |
+   +---+   +---+   +---+---+   +---+   +   +---+   +---+---+   +
|   |                           |   |       |           |       |
+   +---+---+---+---+   +---+   +   +---+---+   +---+---+   +   +
|   |           |   |           |   |           |           |   |
+---+---+   +---+   +---+   +---+   +   +---+   +---+   +   +   +
| G |           |   |   |       |   |           |       |   |   |
+   +---+   +---+---+   +---+   +   +   +---+---+   +---+   +   +
|   |           |       |       |       |       |   |       |   |
+   +---+   +---+   +---+---+   +---+   +   +   +   +   +---+   +
|   |           |       |       |       |   |   |   |           |
+   +   +   +---+   +   +   +   +---+---+   +   +   +   +---+---+
|       |           |   |   |   |           |       |           |
+   +   +   +---+   +   +---+   +---+---+---+---+---+---+---+   +
| S |                           |                               |
+---+---+---+---+---+---+---+---+---+---+---+---+---+---+---+---+
